年份	片名	角色	备注
1973	Yaadon Ki Baaraat	Young Ratan	
1974	Madhosh	Child artist	
1984	Holi	Madan Sharma	
1988	Qayamat Se Qayamat Tak	Raj	印度电影观众奖最佳男新人
印度电影观众奖最佳男主角（Filmfare Best Actor Award）提名
1989	Raakh	Aamir Hussein	国家电影奖特别评审奖（National Film Award – Special Jury Award / Special Mention）
印度电影观众奖最佳男主角提名
Love Love Love	Amit	
1990	Awwal Number	Sunny	
Tum Mere Ho	Shiva	
Dil	Raja	印度电影观众奖最佳男主角提名
Deewana Mujh Sa Nahin	Ajay Sharma	
Jawani Zindabad	Shashi	
1991	Afsana Pyaar Ka	Raj	
Dil Hai Ki Manta Nahin	Raghu Jetley	印度电影观众奖最佳男主角提名
Isi Ka Naam Zindagi	Chotu	
Daulat Ki Jung	Rajesh Chaudhry	
1992	Jo Jeeta Wohi Sikandar	Sanjaylal Sharma	印度电影观众奖最佳男主角提名
1993	Parampara	Ranbir Prithvi Singh	
Hum Hain Rahi Pyar Ke	Rahul Malhotra	印度电影观众奖最佳男主角提名
1994	Andaz Apna Apna	Amar Manohar	印度电影观众奖最佳男主角提名
1995	Baazi	Inspector Amar Damjee	
Aatank Hi Aatank	Rohan	
Rangeela	Munna	印度电影观众奖最佳男主角提名
Akele Hum Akele Tum	Rohit	
1996	Raja Hindustani	Raja Hindustani	印度电影观众奖最佳男主角
1997	Ishq	Raja	
1998	Ghulam	Siddharth Marathe	印度电影观众奖最佳男主角提名
印度电影观众奖最佳男录音提名（Filmfare Best Male Playback Award）
1999	Sarfarosh	Ajay Singh Rathod	印度电影观众奖最佳男主角提名
Mann	Dev Karan Singh	
Earth (1947)	Dil Navaz	
2000	Mela	Kishan Pyare	
2001	印度往事
（Lagaan）	Bhuvan	印度电影观众奖最佳男主角
心归何处
（Dil Chahta Hai）	Akash Malhotra	印度电影观众奖最佳男主角提名
2005	抗暴英雄
（Mangal Pandey: The Rising）	Mangal Pandey	印度电影观众奖最佳男主角提名
2006	芭萨提的颜色
（Rang De Basanti）	Daljit Singh 'DJ'	印度电影观众评论奖最佳表演（Filmfare Critics Award for Best Performance）
印度电影观众奖最佳男主角提名
为爱毁灭
（Fanaa）	Rehan Quadri	
2007	地球上的星星
Zameen Par）	Ram Shankar Nikumbh	印度电影观众奖最佳男配角提名
2008	未知死亡／宝莱坞之记忆拼图
（Ghajini）	Sanjay Singhania	印度电影观众奖最佳男主角提名
2009	Luck by Chance	本人	特别出演
三傻大闹宝莱坞
（3 idiots）	蘭丘霍達斯·沙瑪達斯·昌恰德（蓝丘）／
丘德·冯苏·王杜	印度电影观众奖最佳男主角提名
2011	孟买日记
（Dhobi Ghaat）	Arun	
Delhi Belly		客串
2012	阿米尔罕之大搜索
（Talaash: The Answer Lies Within）	Surjan Singh Shekhawat	
2013	Bombay Talkies	本人	特别演出
Ru-Ba-Ru	本人	纪录片
幻影杀阵3
（Dhoom 3）	Sahir Khan/Samar Khan	分饰两角
打破印度电影全球票房记录
2014	來自星星的傻瓜Pk
（pk）	PK	打破印度电影全球票房记录
印度电影观众奖最佳男主角提名
2015	Dil Dhadakne Do	Pluto Mehra（配音）	
2016	摔跤吧！爸爸
（Dangal）	Mahavir Singh Phogat	打破印度电影全球票房记录
2017	神秘巨星
（Secret Superstar）	沙克帝·库马尔	
2018	印度暴徒
（Thugs of Hindostan）	菲兰吉·马拉（Firangi Mallah）	